                                   
 OO OO OOOOOOOOOO OOOOOOOOOO OO OO 
 OO OO ########## ########## OO OO 
 OO OO OOOOOOOOOO OOOOOOOOOO OO OO 
 OO OO                       OO OO 
 OO OO OOOOOOOOOO OOOOOOOOOO OO OO 
 OO OO ########## ########## OO OO 
 OO OO OOOOOOOOOO OOOOOOOOOO OO OO 
 OO OO                       OO OO 
 OO OO OOOOOOOOOO OOOOOOOOOO OO OO 
 OO OO ########## ########## OO OO 
 OO OO OOOOOOOOOO OOOOOOOOOO OO OO 
 OO OO                       OO OO 
 OO OO OOOOOOOOOO OOOOOOOOOO OO OO 
 OO OO ########## ########## OO OO 
 OO OO OOOOOOOOOO OOOOOOOOOO OO OO 
 OO OO                       OO OO 
 OO OO OOOOOOOOOO OOOOOOOOOO OO OO 
 OO OO ########## ########## OO OO 
 OO OO OOOOOOOOOO OOOOOOOOOO OO OO 
                                   